15 15
S000a0000E0000G
WWAWWW0WW0WWWWW
0000W000W0c0W0W
0WW0WWWWWWW0W0W
0W00W000W000W0W
0W0WW0W0W0W0W0W
0W0000W000W000W
0WWWW0W0W0WWW0W
bW00W0W0WWW0W0W
0W0WW0W000W0W0W
WW0WW0W0W0W0W0W
000000W0WCW000W
0W0WWWWWW0WWWWW
0W00Bd0W000D00e
WWWWWWWWWWWWWWW
